id,account_id,date,daily_inflow,daily_outflow,net_flow,balance,created_at
f45f5a4d-ffa8-4ad7-b4fa-4b3fa334a39f,account_123,2024-03-31,0.0,384.58,-384.58,11914.0,2025-10-26T02:26:04.002669
702cb476-b5a2-429b-a0b9-b8a74bf76421,account_123,2025-01-11,0.0,325.0,-325.0,22691.35,2025-10-26T02:26:04.002669
4e5245a9-3e2b-4517-930b-599ed7fb7966,account_123,2025-04-28,0.0,481.0,-481.0,31376.72,2025-10-26T02:26:04.002669
e2473f45-bdb0-4339-9684-594d3af12720,account_123,2024-01-01,13259.52,325.41,12934.11,12934.11,2025-10-26T02:26:04.002669
1196fafa-0b7d-445c-9b5d-b6f319f3a1d1,account_123,2024-01-02,0.0,45.9,-45.9,12888.21,2025-10-26T02:26:04.002669
052b7828-f690-4e84-92ff-b2b3dc18b1cb,account_123,2024-01-03,0.0,135.49,-135.49,12752.72,2025-10-26T02:26:04.002669
1df75f22-e31a-4803-85af-95bdacbb9b23,account_123,2024-01-05,0.0,8.55,-8.55,12744.17,2025-10-26T02:26:04.002669
e126c637-e74c-4306-9264-f61f11eb24c3,account_123,2024-01-06,0.0,543.91,-543.91,12200.26,2025-10-26T02:26:04.002669
073f5f24-0be7-45f9-b9d6-3b5c7daed43d,account_123,2024-01-07,0.0,270.97,-270.97,11929.29,2025-10-26T02:26:04.002669
8fb15a2e-818f-4d68-b816-3887a9a06147,account_123,2024-01-08,0.0,897.68,-897.68,11031.61,2025-10-26T02:26:04.002669
0fdc43cb-cfa3-4b76-9544-3c659450aa01,account_123,2024-01-09,0.0,42.16,-42.16,10989.45,2025-10-26T02:26:04.002669
a14d367d-4808-4008-9004-004aaeaf203c,account_123,2024-01-10,0.0,114.92,-114.92,10874.53,2025-10-26T02:26:04.002669
b2a5d6ef-4123-4e42-99fe-9e41a3d8d1f1,account_123,2024-01-11,0.0,549.14,-549.14,10325.39,2025-10-26T02:26:04.002669
85d21009-f540-44f1-b6ee-6f4668e526bc,account_123,2024-01-12,0.0,56.79,-56.79,10268.6,2025-10-26T02:26:04.002669
850b7b5d-86ae-4e26-a20e-84443dcaac78,account_123,2024-01-13,0.0,43.33,-43.33,10225.27,2025-10-26T02:26:04.002669
02f0c1d6-8143-4d5e-bc54-bcc238f98ee4,account_123,2024-01-14,0.0,559.54,-559.54,9665.73,2025-10-26T02:26:04.002669
518ee500-9c08-4781-b638-ceafb82d9ab2,account_123,2024-01-15,0.0,276.06,-276.06,9389.67,2025-10-26T02:26:04.002669
0a19d978-f946-46d5-abc2-d9b45fb0c4bb,account_123,2024-01-16,0.0,53.86,-53.86,9335.81,2025-10-26T02:26:04.002669
fc84d648-5ae6-4157-8cd8-22e3550dbf9b,account_123,2024-01-17,0.0,179.45,-179.45,9156.36,2025-10-26T02:26:04.002669
15c5b57d-4733-4e87-9b81-c15cba9d5f77,account_123,2024-01-19,0.0,700.29,-700.29,8456.07,2025-10-26T02:26:04.002669
bcd60c04-7160-49d8-9f7e-747570e63429,account_123,2024-01-20,0.0,222.72,-222.72,8233.35,2025-10-26T02:26:04.002669
8229b974-8eb4-4d83-ae6d-dc247ad62757,account_123,2024-01-21,0.0,1960.01,-1960.01,6273.34,2025-10-26T02:26:04.002669
764c08fe-72e4-4074-8c52-c46c9ff3d635,account_123,2024-01-22,0.0,315.83,-315.83,5957.51,2025-10-26T02:26:04.002669
72ea44f2-b9dd-46f7-8eea-179a21ff6218,account_123,2024-01-23,0.0,94.48,-94.48,5863.03,2025-10-26T02:26:04.002669
ab9fed30-90ae-42ba-8999-68f304099982,account_123,2024-01-24,0.0,69.31,-69.31,5793.72,2025-10-26T02:26:04.002669
2be135eb-4e69-431f-8942-61bd76845bdb,account_123,2024-01-25,0.0,188.84,-188.84,5604.88,2025-10-26T02:26:04.002669
062fbcaa-efd2-47ef-b794-6de56ffd849f,account_123,2024-01-27,0.0,234.28,-234.28,5370.6,2025-10-26T02:26:04.002669
86235287-a1d7-4000-8b8b-1700d69157b6,account_123,2024-01-28,0.0,135.17,-135.17,5235.43,2025-10-26T02:26:04.002669
bbf3b625-6b02-40c7-809e-1cf0f49a7afe,account_123,2024-01-29,0.0,90.52,-90.52,5144.91,2025-10-26T02:26:04.002669
15ddc08a-0bfe-4a7c-8f52-79dd6fa047bc,account_123,2024-01-30,0.0,63.53,-63.53,5081.38,2025-10-26T02:26:04.002669
88fc0653-d471-437a-bd28-0e47d82f0143,account_123,2024-01-31,0.0,328.09,-328.09,4753.29,2025-10-26T02:26:04.002669
30b1365b-45ca-4a1f-881d-792b2a35a7b0,account_123,2024-02-01,13142.02,217.52,12924.5,17677.79,2025-10-26T02:26:04.002669
1d06e71a-1225-4810-9d47-4ee6a2da9db5,account_123,2024-02-02,0.0,142.56,-142.56,17535.23,2025-10-26T02:26:04.002669
7045d9f7-f418-4224-a5a5-9bdc7da0c880,account_123,2024-02-03,0.0,19.36,-19.36,17515.87,2025-10-26T02:26:04.002669
873967ef-5875-4680-a410-b5e370f4286d,account_123,2024-02-04,0.0,106.77,-106.77,17409.1,2025-10-26T02:26:04.002669
5861d3d1-7b2d-4c3c-bbdc-f4d0261d8ff9,account_123,2024-02-05,0.0,389.75,-389.75,17019.35,2025-10-26T02:26:04.002669
fd8d7434-c099-4a71-98eb-7c05fdddaef3,account_123,2024-02-06,0.0,114.3,-114.3,16905.05,2025-10-26T02:26:04.002669
4879e22d-50b1-48e1-9796-7d255d4f9d16,account_123,2024-02-07,0.0,158.14,-158.14,16746.91,2025-10-26T02:26:04.002669
6de5eac8-f8a1-4888-924c-65243925c3c1,account_123,2024-02-08,0.0,56.6,-56.6,16690.31,2025-10-26T02:26:04.002669
a7fd9b4c-2739-4c6f-b0d8-efd9debc54c2,account_123,2024-02-09,0.0,98.32,-98.32,16591.99,2025-10-26T02:26:04.002669
6c9ac041-b878-4459-accd-23fcf032e332,account_123,2024-02-10,0.0,242.33,-242.33,16349.66,2025-10-26T02:26:04.002669
0c30071a-dded-4ee4-bee9-84f2f88ad9e9,account_123,2024-02-11,0.0,412.37,-412.37,15937.29,2025-10-26T02:26:04.002669
eece0dc1-4030-4711-b735-eb2406f67bc6,account_123,2024-02-12,0.0,35.78,-35.78,15901.51,2025-10-26T02:26:04.002669
2f835041-7e16-4719-868c-da1d8c574f4e,account_123,2024-02-13,0.0,245.89,-245.89,15655.62,2025-10-26T02:26:04.002669
3f973a81-025e-45f5-a8b2-b9f55f3faa26,account_123,2024-02-14,0.0,260.17,-260.17,15395.45,2025-10-26T02:26:04.002669
f2c2a275-77be-4ff4-adf2-57a81a88466e,account_123,2024-02-15,0.0,232.49,-232.49,15162.96,2025-10-26T02:26:04.002669
d1bd078e-b702-4249-a2e9-c31f4a3ba601,account_123,2024-02-16,0.0,111.8,-111.8,15051.16,2025-10-26T02:26:04.002669
bc51f673-1f05-44e3-8450-0ff2d8c94b6a,account_123,2024-02-17,0.0,121.85,-121.85,14929.31,2025-10-26T02:26:04.002669
b8a95666-cdc1-465d-bfdc-ba3b94e4cec3,account_123,2024-02-18,0.0,133.12,-133.12,14796.19,2025-10-26T02:26:04.002669
8741da74-8fb0-41b5-a78b-e6454e6da0f4,account_123,2024-02-19,0.0,275.4,-275.4,14520.79,2025-10-26T02:26:04.002669
215aa480-7c91-402e-be69-74e1651eaa2f,account_123,2024-02-20,0.0,95.33,-95.33,14425.46,2025-10-26T02:26:04.002669
a9e06f28-1751-4916-82ca-8fccac1bd8cc,account_123,2024-02-21,0.0,229.73,-229.73,14195.73,2025-10-26T02:26:04.002669
7d109b13-62ad-49de-89d1-c33d249e102a,account_123,2024-02-22,0.0,169.92,-169.92,14025.81,2025-10-26T02:26:04.002669
b7f4fe42-fcb6-40e1-9841-1462504ffd05,account_123,2024-02-23,0.0,214.8,-214.8,13811.01,2025-10-26T02:26:04.002669
862bf74c-3ce1-4507-b2a8-4a3dad1bf469,account_123,2024-02-24,0.0,3590.64,-3590.64,10220.37,2025-10-26T02:26:04.002669
c9fcea68-63e8-400d-8050-d7d329259fa3,account_123,2024-02-25,0.0,293.49,-293.49,9926.88,2025-10-26T02:26:04.002669
772ff518-511a-4615-8b79-f54863f19fd6,account_123,2024-02-26,0.0,365.0,-365.0,9561.88,2025-10-26T02:26:04.002669
2b698596-bb79-4bb7-901c-e7320fa79bb2,account_123,2024-02-27,0.0,81.72,-81.72,9480.16,2025-10-26T02:26:04.002669
889ca12d-31ed-4af5-9b8e-7ac1931a0de0,account_123,2024-02-28,0.0,377.64,-377.64,9102.52,2025-10-26T02:26:04.002669
ce8a41c6-466b-437a-8000-2937bcc9b83c,account_123,2024-03-01,13023.96,110.62,12913.34,22015.86,2025-10-26T02:26:04.002669
09116e45-5223-44c2-baee-2c2d522021d9,account_123,2024-03-02,0.0,507.21,-507.21,21508.65,2025-10-26T02:26:04.002669
5240a40e-7bda-4882-ab3d-06e078c37476,account_123,2024-03-03,0.0,334.79,-334.79,21173.86,2025-10-26T02:26:04.002669
2bad50cf-4c06-42a7-899b-111c6cd6340b,account_123,2024-03-04,0.0,616.09,-616.09,20557.77,2025-10-26T02:26:04.002669
a265de1f-5894-4def-85f1-35778e5411bb,account_123,2024-03-05,0.0,211.72,-211.72,20346.05,2025-10-26T02:26:04.002669
1f81000e-cbe1-4761-9d52-79021f52ceb6,account_123,2024-03-06,0.0,297.32,-297.32,20048.73,2025-10-26T02:26:04.002669
a7f77f9f-072a-44ec-8110-f1fd1324aff1,account_123,2024-03-07,0.0,389.52,-389.52,19659.21,2025-10-26T02:26:04.002669
39d631bd-4538-45da-8511-4a3066d5fdc0,account_123,2024-03-08,0.0,158.94,-158.94,19500.27,2025-10-26T02:26:04.002669
94a0d4cb-5ace-4793-9d39-4d0f6d421f70,account_123,2024-03-09,0.0,406.2,-406.2,19094.07,2025-10-26T02:26:04.002669
9ae5dff5-0bf4-4097-aba8-b144d622138a,account_123,2024-03-10,0.0,509.62,-509.62,18584.45,2025-10-26T02:26:04.002669
3cc424ee-f416-4d41-ad50-f1613a798447,account_123,2024-03-11,0.0,385.0,-385.0,18199.45,2025-10-26T02:26:04.002669
136456ea-abdc-45a6-a3f6-4f94d076b838,account_123,2024-03-12,0.0,46.19,-46.19,18153.26,2025-10-26T02:26:04.002669
dfc5bd63-f399-4f9e-b082-3e7fc5fa2ebf,account_123,2024-03-13,0.0,261.65,-261.65,17891.61,2025-10-26T02:26:04.002669
0e597372-890f-40fe-9e3b-1679d8e13f7f,account_123,2024-03-14,0.0,386.75,-386.75,17504.86,2025-10-26T02:26:04.002669
ab7ad080-45a1-4c3a-81f8-d3063f110d4b,account_123,2024-03-15,0.0,113.28,-113.28,17391.58,2025-10-26T02:26:04.002669
36a62606-b141-4809-b537-0017c0a458c6,account_123,2024-03-16,0.0,571.83,-571.83,16819.75,2025-10-26T02:26:04.002669
c012b071-7037-4bda-8d08-fc59188e5c3f,account_123,2024-03-17,0.0,615.4,-615.4,16204.35,2025-10-26T02:26:04.002669
f53e0b79-f054-4c34-9736-4f13497efdbc,account_123,2024-03-18,0.0,252.09,-252.09,15952.26,2025-10-26T02:26:04.002669
82aa78e5-3962-4c69-aec6-8ca975bf6c25,account_123,2024-03-19,0.0,61.75,-61.75,15890.51,2025-10-26T02:26:04.002669
65f8e127-7e34-4df9-b8bf-b55ef1740b14,account_123,2024-03-20,0.0,53.92,-53.92,15836.59,2025-10-26T02:26:04.002669
189f6d48-6bf9-45c4-bcd2-96178f6b05a2,account_123,2024-03-21,0.0,135.62,-135.62,15700.97,2025-10-26T02:26:04.002669
2d4ec9cf-8423-496a-99ff-5dc7381f5616,account_123,2024-03-22,0.0,884.78,-884.78,14816.19,2025-10-26T02:26:04.002669
ac57ae7e-d359-4756-a10b-d76d2c0590de,account_123,2024-03-23,0.0,274.06,-274.06,14542.13,2025-10-26T02:26:04.002669
71b044d0-4266-4085-a8ab-8502c6197e64,account_123,2024-03-24,0.0,264.92,-264.92,14277.21,2025-10-26T02:26:04.002669
4ea6da7c-b115-4c4e-8b97-8ec0aba1edb9,account_123,2024-03-25,0.0,119.13,-119.13,14158.08,2025-10-26T02:26:04.002669
9ed7a929-9106-4d0d-9a8b-456e1454fb9d,account_123,2024-03-26,0.0,547.5,-547.5,13610.58,2025-10-26T02:26:04.002669
24dae18b-2a19-41e1-a791-394d0bd9bcec,account_123,2024-03-27,0.0,262.64,-262.64,13347.94,2025-10-26T02:26:04.002669
6aa4fa25-a3c1-472b-8f2a-335512aa19e1,account_123,2024-03-28,0.0,107.25,-107.25,13240.69,2025-10-26T02:26:04.002669
c71c87d0-acca-4ef4-a1b8-f922437e1936,account_123,2024-03-29,0.0,442.77,-442.77,12797.92,2025-10-26T02:26:04.002669
2e6fe034-9bbf-4c24-9394-4295c4d42ce3,account_123,2024-03-30,0.0,499.34,-499.34,12298.58,2025-10-26T02:26:04.002669
4f3a6e99-96d4-4356-b6e7-8d7c07be1b26,account_123,2024-04-01,12840.74,867.07,11973.67,23887.67,2025-10-26T02:26:04.002669
96a9fbdb-5d38-42e7-bd71-0cd0255119c9,account_123,2024-04-02,0.0,105.57,-105.57,23782.1,2025-10-26T02:26:04.002669
6886b599-eca2-48da-aef1-c7a2213bbd6f,account_123,2024-04-03,0.0,93.69,-93.69,23688.41,2025-10-26T02:26:04.002669
a8c49719-74b7-4b4b-a087-aa52300c29c9,account_123,2024-04-04,0.0,570.94,-570.94,23117.47,2025-10-26T02:26:04.002669
645779fa-b687-4bba-883a-c5cb02626453,account_123,2024-04-05,0.0,159.49,-159.49,22957.98,2025-10-26T02:26:04.002669
b54b0d03-b510-4498-8026-95f6c99a3788,account_123,2024-04-06,0.0,92.49,-92.49,22865.49,2025-10-26T02:26:04.002669
a63e5dd3-961f-4d16-b440-8553c67f3c4b,account_123,2024-04-07,0.0,468.32,-468.32,22397.17,2025-10-26T02:26:04.002669
b57c77e4-b0a7-4bad-a2eb-5f4e59414410,account_123,2024-04-08,0.0,161.61,-161.61,22235.56,2025-10-26T02:26:04.002669
af03adc5-1964-445c-b64f-5a85e5da8e7e,account_123,2024-04-09,0.0,323.27,-323.27,21912.29,2025-10-26T02:26:04.002669
547cee00-4a01-42a4-af99-1e2608f1976d,account_123,2024-04-10,0.0,296.4,-296.4,21615.89,2025-10-26T02:26:04.002669
055dab92-b2ce-4765-871c-519d97d0359b,account_123,2024-04-11,0.0,298.75,-298.75,21317.14,2025-10-26T02:26:04.002669
f753a7bb-542a-4034-8404-33d01e49788c,account_123,2024-04-12,0.0,711.28,-711.28,20605.86,2025-10-26T02:26:04.002669
db0d8e96-4bee-4ea5-bcb5-50b57b710105,account_123,2024-04-13,0.0,129.84,-129.84,20476.02,2025-10-26T02:26:04.002669
1b3560d0-be06-41ee-8f3b-38fce9abe836,account_123,2024-04-14,0.0,2.01,-2.01,20474.01,2025-10-26T02:26:04.002669
16a47097-3f23-4f4e-95f7-138c36107a00,account_123,2024-04-15,0.0,152.13,-152.13,20321.88,2025-10-26T02:26:04.002669
0ad7e565-f40f-4e57-9220-6d9f343ead0c,account_123,2024-04-16,0.0,16.78,-16.78,20305.1,2025-10-26T02:26:04.002669
0c8b8621-ea33-4a97-8a31-684525a5b654,account_123,2024-04-17,0.0,142.19,-142.19,20162.91,2025-10-26T02:26:04.002669
92655680-0a2b-4087-8fff-18e206ad896b,account_123,2024-04-18,0.0,347.78,-347.78,19815.13,2025-10-26T02:26:04.002669
3aeec193-1961-43a1-866c-7745a89326e8,account_123,2024-04-19,0.0,174.37,-174.37,19640.76,2025-10-26T02:26:04.002669
e60a1425-5d4c-45dd-9b45-78a0cff8e50a,account_123,2024-04-20,0.0,287.84,-287.84,19352.92,2025-10-26T02:26:04.002669
768c6438-d44d-4ba8-b34b-bd44914529ff,account_123,2024-04-21,0.0,255.07,-255.07,19097.85,2025-10-26T02:26:04.002669
a14b3c94-e4dc-4940-a911-fda871d43d1e,account_123,2024-04-22,0.0,130.11,-130.11,18967.74,2025-10-26T02:26:04.002669
dd87df49-99f1-4431-a5bd-2dd87bdb6a0d,account_123,2024-04-23,0.0,305.12,-305.12,18662.62,2025-10-26T02:26:04.002669
208a1513-1c29-4cc2-913f-a84c92b70458,account_123,2024-04-24,0.0,299.21,-299.21,18363.41,2025-10-26T02:26:04.002669
f9a7fc77-b4b4-47ca-a295-2b7154acc8dd,account_123,2024-04-25,0.0,832.86,-832.86,17530.55,2025-10-26T02:26:04.002669
40dddcec-82cb-4c74-922c-8f4302e4db5b,account_123,2024-04-26,0.0,183.68,-183.68,17346.87,2025-10-26T02:26:04.002669
3b2fcec7-ba34-499d-8725-5b82ff37fff3,account_123,2024-04-27,0.0,332.28,-332.28,17014.59,2025-10-26T02:26:04.002669
745dddad-9c9c-403d-9c23-dbbb2d92b677,account_123,2024-04-28,0.0,92.32,-92.32,16922.27,2025-10-26T02:26:04.002669
81b4414e-9d44-49e7-a77b-374cc482aab1,account_123,2024-04-29,0.0,273.37,-273.37,16648.9,2025-10-26T02:26:04.002669
2474c218-b5ad-43b8-97b0-5724e2dfea41,account_123,2024-04-30,0.0,305.53,-305.53,16343.37,2025-10-26T02:26:04.002669
36062d3b-a1c1-4f98-a3ac-db30e582edb4,account_123,2024-05-01,13063.98,204.33,12859.65,29203.02,2025-10-26T02:26:04.002669
0013a5c7-b7c5-4b4b-84e0-eb8d0ec381ae,account_123,2024-05-02,0.0,54.0,-54.0,29149.02,2025-10-26T02:26:04.002669
d3442a2a-d7b1-4746-ac05-6c6ae4589629,account_123,2024-05-03,0.0,485.07,-485.07,28663.95,2025-10-26T02:26:04.002669
a6266d04-85a4-49aa-b55b-9c9abf1181db,account_123,2024-05-04,0.0,282.19,-282.19,28381.76,2025-10-26T02:26:04.002669
f386c113-2d53-4076-9d2b-d534f1ddaf84,account_123,2024-05-05,0.0,434.18,-434.18,27947.58,2025-10-26T02:26:04.002669
dd1d067c-adac-42c5-b79e-13ac8fb54951,account_123,2024-05-06,0.0,241.02,-241.02,27706.56,2025-10-26T02:26:04.002669
10e07e98-f018-4c3d-a7cc-0ddb7bcc6d25,account_123,2024-05-07,0.0,123.65,-123.65,27582.91,2025-10-26T02:26:04.002669
ead294c5-172c-4d8f-9392-94ca004b9d83,account_123,2024-05-08,0.0,376.27,-376.27,27206.64,2025-10-26T02:26:04.002669
991ea1ee-aa67-4df4-8d90-c53403202245,account_123,2024-05-09,0.0,430.04,-430.04,26776.6,2025-10-26T02:26:04.002669
065523f9-8c89-4031-90f2-9909b7815982,account_123,2024-05-10,0.0,479.55,-479.55,26297.05,2025-10-26T02:26:04.002669
90535777-07a9-45b3-8ed0-3cc39df3ddbb,account_123,2024-05-11,0.0,55.7,-55.7,26241.35,2025-10-26T02:26:04.002669
221fa569-afc4-4870-a788-7e2e7241a3dd,account_123,2024-05-12,0.0,558.37,-558.37,25682.98,2025-10-26T02:26:04.002669
83ee8d82-728c-498c-83d8-23d29a0700fe,account_123,2024-05-13,0.0,618.98,-618.98,25064.0,2025-10-26T02:26:04.002669
9bd6452f-a981-4598-96b3-9bd479a5ae71,account_123,2024-05-15,0.0,174.93,-174.93,24889.07,2025-10-26T02:26:04.002669
e82a9dd6-37d5-473b-b2bc-70ccb829e01e,account_123,2024-05-16,0.0,258.92,-258.92,24630.15,2025-10-26T02:26:04.002669
86efab8f-fbd9-4610-823a-27c7b3ca4297,account_123,2024-05-17,0.0,476.15,-476.15,24154.0,2025-10-26T02:26:04.002669
268cd1d3-ec8d-4980-9774-6a0ba69491a1,account_123,2024-05-18,0.0,244.95,-244.95,23909.05,2025-10-26T02:26:04.002669
daa772ac-e0fc-4eed-b3ce-591e16ee9d57,account_123,2024-05-19,0.0,228.8,-228.8,23680.25,2025-10-26T02:26:04.002669
9394e0a0-a99f-4656-8f91-45482825b537,account_123,2024-05-20,0.0,299.68,-299.68,23380.57,2025-10-26T02:26:04.002669
3485a34d-6bd3-4df5-a6cd-c2a95623ccb8,account_123,2024-05-21,0.0,116.61,-116.61,23263.96,2025-10-26T02:26:04.002669
12968a2d-1f2a-4fdb-8ed1-87575b092fb9,account_123,2024-05-22,0.0,431.83,-431.83,22832.13,2025-10-26T02:26:04.002669
fc4fb27f-7629-4959-a6d2-ded643c530f6,account_123,2024-05-23,0.0,87.03,-87.03,22745.1,2025-10-26T02:26:04.002669
81d29c52-817f-4678-8af0-49854e8ad71d,account_123,2024-05-24,0.0,623.75,-623.75,22121.35,2025-10-26T02:26:04.002669
bf943b38-046a-4b92-b081-0495828878c2,account_123,2024-05-25,0.0,355.91,-355.91,21765.44,2025-10-26T02:26:04.002669
239d5e07-b66b-4681-b5f7-74f549bc035e,account_123,2024-05-26,0.0,829.64,-829.64,20935.8,2025-10-26T02:26:04.002669
67942fe8-4828-418a-a784-7541930512f0,account_123,2024-05-27,0.0,409.16,-409.16,20526.64,2025-10-26T02:26:04.002669
fd9a67dc-88f7-4d06-9b48-6b3ace886b9c,account_123,2024-05-28,0.0,33.9,-33.9,20492.74,2025-10-26T02:26:04.002669
f372ce56-5c69-4245-9ece-dae7ffcfa5f2,account_123,2024-05-29,0.0,297.21,-297.21,20195.53,2025-10-26T02:26:04.002669
a32ac6d1-4040-45c9-b231-e17d6603f876,account_123,2024-05-30,0.0,147.11,-147.11,20048.42,2025-10-26T02:26:04.002669
05ee3631-23ff-49a0-81ef-f00662556ba0,account_123,2024-05-31,0.0,229.63,-229.63,19818.79,2025-10-26T02:26:04.002669
61d92f1e-67d0-40f4-a1ae-331b5c39458f,account_123,2024-06-01,12201.81,427.66,11774.15,31592.94,2025-10-26T02:26:04.002669
a51ebdb1-d15b-4610-9321-ba11503c1ac6,account_123,2024-06-02,0.0,447.37,-447.37,31145.57,2025-10-26T02:26:04.002669
31b86cfb-05f8-42ed-b06e-11a7b0932c92,account_123,2024-06-03,0.0,634.37,-634.37,30511.2,2025-10-26T02:26:04.002669
31c4d1fe-da16-4c7e-956d-9679081e59df,account_123,2024-06-04,0.0,315.31,-315.31,30195.89,2025-10-26T02:26:04.002669
fd7eb9e0-4f0a-4e44-9351-634e2dfa26e8,account_123,2024-06-05,0.0,121.76,-121.76,30074.13,2025-10-26T02:26:04.002669
f147f547-665c-4441-81d2-0d10dc579c3a,account_123,2024-06-06,0.0,267.89,-267.89,29806.24,2025-10-26T02:26:04.002669
4325952e-6251-4bd9-946c-f89e1ba38749,account_123,2024-06-07,0.0,275.35,-275.35,29530.89,2025-10-26T02:26:04.002669
cb8a3500-a572-4f3d-8494-dce4955abdb0,account_123,2024-06-08,0.0,723.12,-723.12,28807.77,2025-10-26T02:26:04.002669
1b3b6e18-40f3-43c2-b69d-aa1920f68ca6,account_123,2024-06-09,0.0,366.54,-366.54,28441.23,2025-10-26T02:26:04.002669
d25bd126-b353-41c3-9116-440c5f60cc13,account_123,2024-06-10,0.0,317.4,-317.4,28123.83,2025-10-26T02:26:04.002669
4d60bd65-83ab-47a4-b24b-c1c53e939938,account_123,2024-06-11,0.0,375.34,-375.34,27748.49,2025-10-26T02:26:04.002669
958d3654-f9c4-4176-8963-0302b402542a,account_123,2024-06-12,0.0,594.3,-594.3,27154.19,2025-10-26T02:26:04.002669
64965f82-55bb-402c-83fe-3c39cee1c978,account_123,2024-06-13,0.0,186.6,-186.6,26967.59,2025-10-26T02:26:04.002669
3c048429-2b8a-40db-be77-4ed8d4de158f,account_123,2024-06-14,0.0,173.65,-173.65,26793.94,2025-10-26T02:26:04.002669
13c7fdcb-6b92-41fd-b418-15b2fdf92957,account_123,2024-06-15,0.0,145.01,-145.01,26648.93,2025-10-26T02:26:04.002669
bb8e1038-4b01-4fa7-8ee2-f108ae08dcf7,account_123,2024-06-16,0.0,576.89,-576.89,26072.04,2025-10-26T02:26:04.002669
c46a61e2-2d35-4676-8cb5-0ec3449dd953,account_123,2024-06-17,0.0,168.23,-168.23,25903.81,2025-10-26T02:26:04.002669
a7cd7752-39df-41cd-8623-991f5bfad84f,account_123,2024-06-18,0.0,89.94,-89.94,25813.87,2025-10-26T02:26:04.002669
b66c2970-bc10-4a41-af28-704a3f79270b,account_123,2024-06-19,0.0,34.22,-34.22,25779.65,2025-10-26T02:26:04.002669
7d374bd4-c4ed-42a6-a56b-a3cc7f3cbfc7,account_123,2024-06-20,0.0,388.48,-388.48,25391.17,2025-10-26T02:26:04.002669
83b8d7b4-d0a2-4563-897d-bb49b51acf90,account_123,2024-06-21,0.0,223.86,-223.86,25167.31,2025-10-26T02:26:04.002669
7ada366c-248e-47be-8d28-01d3a9584aba,account_123,2024-06-22,0.0,2825.46,-2825.46,22341.85,2025-10-26T02:26:04.002669
323352f1-3ed3-407b-9940-72a2c8e158ab,account_123,2024-06-23,0.0,1360.65,-1360.65,20981.2,2025-10-26T02:26:04.002669
fc2f7423-0cee-4008-95ef-79eb7e88833f,account_123,2024-06-24,0.0,265.5,-265.5,20715.7,2025-10-26T02:26:04.002669
60aef721-9964-4046-8be3-a81e86bad434,account_123,2024-06-25,0.0,8.0,-8.0,20707.7,2025-10-26T02:26:04.002669
50140d3e-6960-441f-8e93-a1ff4f81465e,account_123,2024-06-26,0.0,476.96,-476.96,20230.74,2025-10-26T02:26:04.002669
6141433f-8f70-4f36-88fc-714b7116ee2e,account_123,2024-06-27,0.0,439.5,-439.5,19791.24,2025-10-26T02:26:04.002669
7be28bc5-2230-414f-8207-a8b8c656d4b3,account_123,2024-06-28,0.0,204.09,-204.09,19587.15,2025-10-26T02:26:04.002669
65929fba-af11-474b-b022-192e340c397b,account_123,2024-06-29,0.0,220.15,-220.15,19367.0,2025-10-26T02:26:04.002669
db2e915a-7966-4d67-89b4-bea25d2d041a,account_123,2024-06-30,0.0,354.89,-354.89,19012.11,2025-10-26T02:26:04.002669
3e4541af-33bd-4969-9425-ae91606c2e9c,account_123,2024-07-01,13265.65,461.71,12803.94,31816.05,2025-10-26T02:26:04.002669
d8a1d953-03f4-4026-8fe0-321c03d13d17,account_123,2024-07-02,0.0,92.67,-92.67,31723.38,2025-10-26T02:26:04.002669
f2c5d541-6167-4d89-a195-4c63dc00a3d9,account_123,2024-07-03,0.0,160.71,-160.71,31562.67,2025-10-26T02:26:04.002669
6c5c5b40-6fd8-42de-b14b-b81452fef204,account_123,2024-07-04,0.0,167.29,-167.29,31395.38,2025-10-26T02:26:04.002669
79cab77b-49d7-4462-a4cf-342cde17ede5,account_123,2024-07-05,0.0,398.31,-398.31,30997.07,2025-10-26T02:26:04.002669
2a5e3188-9a35-427a-80d9-c98555246f23,account_123,2024-07-06,0.0,287.12,-287.12,30709.95,2025-10-26T02:26:04.002669
9b00beae-8434-4213-9b1c-46104b1c5393,account_123,2024-07-07,0.0,1174.99,-1174.99,29534.96,2025-10-26T02:26:04.002669
ac253f12-2850-40b4-9555-c1a6e15f366f,account_123,2024-07-08,0.0,2255.21,-2255.21,27279.75,2025-10-26T02:26:04.002669
39126e6c-9c8d-4ce4-b211-b68898be9521,account_123,2024-07-09,0.0,676.54,-676.54,26603.21,2025-10-26T02:26:04.002669
471eabe8-f3ed-4931-b4a2-683d78f3c245,account_123,2024-07-10,0.0,135.26,-135.26,26467.95,2025-10-26T02:26:04.002669
7495e3c8-ec9a-44c3-a770-69ad0e95a75b,account_123,2024-07-11,0.0,221.37,-221.37,26246.58,2025-10-26T02:26:04.002669
1ef96129-5df4-4b97-860a-fd902810d6b5,account_123,2024-07-12,0.0,236.18,-236.18,26010.4,2025-10-26T02:26:04.002669
0203e6b5-e02e-4d82-974c-46a100cd0c07,account_123,2024-07-13,0.0,214.24,-214.24,25796.16,2025-10-26T02:26:04.002669
857c2b20-c080-4245-a891-3cb82c2f21d6,account_123,2024-07-14,0.0,85.0,-85.0,25711.16,2025-10-26T02:26:04.002669
01769a61-689f-4239-9414-eebf346d0c71,account_123,2024-07-15,0.0,396.2,-396.2,25314.96,2025-10-26T02:26:04.002669
02132deb-588a-49a7-8303-0cc2a3c370b5,account_123,2024-07-16,0.0,426.93,-426.93,24888.03,2025-10-26T02:26:04.002669
52878f3a-2adc-421c-b032-bedf4f3d045c,account_123,2024-07-17,0.0,705.28,-705.28,24182.75,2025-10-26T02:26:04.002669
41925401-3b34-4cd3-8e08-ddf64a934e40,account_123,2024-07-18,0.0,328.17,-328.17,23854.58,2025-10-26T02:26:04.002669
7c8336f3-0616-47b1-9172-99a6d1a6f967,account_123,2024-07-19,0.0,46.62,-46.62,23807.96,2025-10-26T02:26:04.002669
74c5e2f3-a49e-4974-b44a-0bd19d1ca16d,account_123,2024-07-20,0.0,492.34,-492.34,23315.62,2025-10-26T02:26:04.002669
bfff2d4f-9a84-4c1f-861d-da8b48f412c3,account_123,2024-07-21,0.0,747.25,-747.25,22568.37,2025-10-26T02:26:04.002669
0bde364e-a77a-47e0-819a-0e6c2f7160f3,account_123,2024-07-22,0.0,1466.01,-1466.01,21102.36,2025-10-26T02:26:04.002669
eeffcc30-5c0c-4634-831b-9ea9f67ffe82,account_123,2024-07-23,0.0,200.26,-200.26,20902.1,2025-10-26T02:26:04.002669
1283baac-512c-404f-afb7-c854ea344b01,account_123,2024-07-24,0.0,706.62,-706.62,20195.48,2025-10-26T02:26:04.002669
12f5abaf-0278-4221-b5b8-1a5d7ce8e899,account_123,2024-07-25,0.0,187.57,-187.57,20007.91,2025-10-26T02:26:04.002669
f8ff1fa7-3b19-44bc-a922-6415a85b5c8e,account_123,2024-07-26,0.0,163.34,-163.34,19844.57,2025-10-26T02:26:04.002669
c1af8298-3e40-4cff-81ac-90d2de663c94,account_123,2024-07-27,0.0,637.23,-637.23,19207.34,2025-10-26T02:26:04.002669
272b41d0-2687-4269-bb11-3092b764f77d,account_123,2024-07-28,0.0,472.07,-472.07,18735.27,2025-10-26T02:26:04.002669
76c771f2-09a6-4e62-94d2-3ae4bb17d3b3,account_123,2024-07-29,0.0,408.32,-408.32,18326.95,2025-10-26T02:26:04.002669
1f215f1e-8c80-4942-9f78-a3a4888e1504,account_123,2024-07-30,0.0,157.16,-157.16,18169.79,2025-10-26T02:26:04.002669
e051f80b-61e7-4fe7-b8cb-4e42c8c02ba9,account_123,2024-07-31,0.0,340.92,-340.92,17828.87,2025-10-26T02:26:04.002669
85b22283-9beb-46b0-b927-5e2e80b1d33d,account_123,2024-08-01,12376.21,645.33,11730.88,29559.75,2025-10-26T02:26:04.002669
41f0ac8f-ed29-4675-96f5-b568ba682cce,account_123,2024-08-02,0.0,1876.1,-1876.1,27683.65,2025-10-26T02:26:04.002669
5d1a947a-9b19-4d45-b37c-2082f97cdc29,account_123,2024-08-03,0.0,907.35,-907.35,26776.3,2025-10-26T02:26:04.002669
5970a8ca-732a-4f8a-b93d-f385e4809e40,account_123,2024-08-04,0.0,717.35,-717.35,26058.95,2025-10-26T02:26:04.002669
71b9fbc5-69e3-4711-acaa-bf1d7ae58891,account_123,2024-08-05,0.0,550.6,-550.6,25508.35,2025-10-26T02:26:04.002669
df5a1772-2dd3-40f2-8433-b7a18db591fc,account_123,2024-08-06,0.0,170.1,-170.1,25338.25,2025-10-26T02:26:04.002669
54043e3b-6304-4502-8d84-556a0f422028,account_123,2024-08-07,0.0,284.31,-284.31,25053.94,2025-10-26T02:26:04.002669
145eab08-75fb-44ca-8bbb-41996331d65c,account_123,2024-08-08,0.0,368.81,-368.81,24685.13,2025-10-26T02:26:04.002669
669da956-243c-4eab-9eef-515c6ad31991,account_123,2024-08-09,0.0,128.02,-128.02,24557.11,2025-10-26T02:26:04.002669
5dc2cc07-87a5-4668-91c3-80d7bdb61f43,account_123,2024-08-10,0.0,48.44,-48.44,24508.67,2025-10-26T02:26:04.002669
2b890e3a-1e94-42be-ab66-7c8db7fa2f40,account_123,2024-08-11,0.0,278.19,-278.19,24230.48,2025-10-26T02:26:04.002669
1dd505c9-f842-45f8-bde6-3ae7fae6aed2,account_123,2024-08-12,0.0,489.24,-489.24,23741.24,2025-10-26T02:26:04.002669
8f77acf0-86a3-46e9-83ea-6bbd9c52595c,account_123,2024-08-13,0.0,225.84,-225.84,23515.4,2025-10-26T02:26:04.002669
b8817f01-bc09-4131-9a4b-991749d2843f,account_123,2024-08-14,0.0,744.19,-744.19,22771.21,2025-10-26T02:26:04.002669
950105b2-7e52-4795-a801-025f17e968b6,account_123,2024-08-15,0.0,305.01,-305.01,22466.2,2025-10-26T02:26:04.002669
b6f1cc5c-ce6d-4a38-affd-b41008b9e0cf,account_123,2024-08-16,0.0,296.58,-296.58,22169.62,2025-10-26T02:26:04.002669
e6b7b0bd-4510-4502-90a2-f04508e596f9,account_123,2024-08-17,0.0,629.67,-629.67,21539.95,2025-10-26T02:26:04.002669
d2cee673-da02-462d-9bff-a229d348365f,account_123,2024-08-18,0.0,388.79,-388.79,21151.16,2025-10-26T02:26:04.002669
02db276a-186e-4973-9bd1-4d1aed521be5,account_123,2024-08-19,0.0,440.14,-440.14,20711.02,2025-10-26T02:26:04.002669
8526ebbe-f573-4e52-afcd-e0b0f8b45980,account_123,2024-08-20,0.0,633.18,-633.18,20077.84,2025-10-26T02:26:04.002669
9e5e2b67-5a16-4011-bb5a-f5caec7aad00,account_123,2024-08-21,0.0,227.83,-227.83,19850.01,2025-10-26T02:26:04.002669
5e4b20be-2175-4131-8a17-375a1c1a85f2,account_123,2024-08-22,0.0,338.65,-338.65,19511.36,2025-10-26T02:26:04.002669
9de5849e-1a64-402a-869b-de3bde818f56,account_123,2024-08-23,0.0,162.45,-162.45,19348.91,2025-10-26T02:26:04.002669
dbb47f4c-53b0-4cd3-90e1-bd265aafcc9b,account_123,2024-08-24,0.0,216.9,-216.9,19132.01,2025-10-26T02:26:04.002669
46b6c447-6968-40ca-b2fa-de5054537d27,account_123,2024-08-25,0.0,422.17,-422.17,18709.84,2025-10-26T02:26:04.002669
97f0eba1-ea9d-4143-a459-c3443c8c6187,account_123,2024-08-26,0.0,290.76,-290.76,18419.08,2025-10-26T02:26:04.002669
86613ce3-7da5-473a-94b3-bca676fa7039,account_123,2024-08-27,0.0,271.79,-271.79,18147.29,2025-10-26T02:26:04.002669
c5ac76ce-ff03-4f54-a745-daf8a1a32b00,account_123,2024-08-28,0.0,335.65,-335.65,17811.64,2025-10-26T02:26:04.002669
6782600a-c9b8-4370-82fe-92a511f3e4da,account_123,2024-08-29,0.0,664.71,-664.71,17146.93,2025-10-26T02:26:04.002669
8a95aa15-a361-4cfc-b58b-07b1d51d1622,account_123,2024-08-30,0.0,566.96,-566.96,16579.97,2025-10-26T02:26:04.002669
edea2b7b-e4bb-4e8b-a522-e966e0d3fb30,account_123,2024-08-31,0.0,648.82,-648.82,15931.15,2025-10-26T02:26:04.002669
170ac59f-b2db-45ca-92fe-f88d91db05f1,account_123,2024-09-01,12908.26,544.58,12363.68,28294.83,2025-10-26T02:26:04.002669
71556ba1-66b5-4714-8f9c-430ac6db0fb8,account_123,2024-09-02,0.0,284.01,-284.01,28010.82,2025-10-26T02:26:04.002669
725392a0-30eb-414e-b3c7-e282a876f155,account_123,2024-09-03,0.0,198.32,-198.32,27812.5,2025-10-26T02:26:04.002669
fbce2c90-660a-4d8a-be42-d3a8aaaecdb7,account_123,2024-09-04,0.0,256.36,-256.36,27556.14,2025-10-26T02:26:04.002669
04a266a3-3267-448f-98ac-68108eddfb6a,account_123,2024-09-05,0.0,520.58,-520.58,27035.56,2025-10-26T02:26:04.002669
4356073f-b07c-446a-8cbd-d7b51a68f845,account_123,2024-09-06,0.0,253.25,-253.25,26782.31,2025-10-26T02:26:04.002669
4d604a59-5ca8-4616-9a2c-ab34b0ce7122,account_123,2024-09-07,0.0,564.25,-564.25,26218.06,2025-10-26T02:26:04.002669
f7502113-fc0c-49d3-9cfe-2ca587c1b44d,account_123,2024-09-08,0.0,2361.07,-2361.07,23856.99,2025-10-26T02:26:04.002669
679743f7-c695-40a0-88a8-1381f46d5bd3,account_123,2024-09-09,0.0,380.67,-380.67,23476.32,2025-10-26T02:26:04.002669
a8f7f035-2880-4e04-a6f4-32a0e69723ea,account_123,2024-09-10,0.0,112.95,-112.95,23363.37,2025-10-26T02:26:04.002669
1a10a84a-e19a-4ffa-a55d-c6dc90a02835,account_123,2024-09-11,0.0,336.09,-336.09,23027.28,2025-10-26T02:26:04.002669
df3a33d1-0091-4f2e-a972-0addea5241e2,account_123,2024-09-12,0.0,111.19,-111.19,22916.09,2025-10-26T02:26:04.002669
13d97f25-f4e0-49a9-bbab-05677a1dc8e7,account_123,2024-09-13,0.0,1561.09,-1561.09,21355.0,2025-10-26T02:26:04.002669
0d1150f8-427a-4559-b2f8-c1eec52d3253,account_123,2024-09-14,0.0,737.61,-737.61,20617.39,2025-10-26T02:26:04.002669
94fba875-9268-48f8-94b0-4e31d6ba799c,account_123,2024-09-15,0.0,233.39,-233.39,20384.0,2025-10-26T02:26:04.002669
8a4f279a-65c2-4c53-900d-5f70bd258135,account_123,2024-09-16,0.0,198.6,-198.6,20185.4,2025-10-26T02:26:04.002669
b38613a9-9a5b-401b-8068-d3ebc484afa5,account_123,2024-09-17,0.0,70.79,-70.79,20114.61,2025-10-26T02:26:04.002669
c7249701-87e5-4483-9fc3-360725d89ce0,account_123,2024-09-18,0.0,130.67,-130.67,19983.94,2025-10-26T02:26:04.002669
578ff9e6-5fa1-40a7-bd11-a00b2bed1d66,account_123,2024-09-19,0.0,298.37,-298.37,19685.57,2025-10-26T02:26:04.002669
95c95cbd-51de-4694-bd8f-c7cc24241827,account_123,2024-09-20,0.0,439.6,-439.6,19245.97,2025-10-26T02:26:04.002669
5b2c42ab-5606-43e3-af6d-da1d0455cc19,account_123,2024-09-21,0.0,86.42,-86.42,19159.55,2025-10-26T02:26:04.002669
95a714a6-9400-4edf-9af6-48fafff26fea,account_123,2024-09-22,0.0,186.5,-186.5,18973.05,2025-10-26T02:26:04.002669
aa71483d-4e91-41a5-a9bf-4e633e5b7b1e,account_123,2024-09-23,0.0,331.31,-331.31,18641.74,2025-10-26T02:26:04.002669
5cc7dfa8-f3fa-4f1b-bf72-97ea766974db,account_123,2024-09-25,0.0,25.77,-25.77,18615.97,2025-10-26T02:26:04.002669
e84b53c0-0c90-4346-974c-097ffc09e9f0,account_123,2024-09-26,0.0,85.13,-85.13,18530.84,2025-10-26T02:26:04.002669
f7ac592c-2b5d-4813-9052-32d417ded24e,account_123,2024-09-27,0.0,719.42,-719.42,17811.42,2025-10-26T02:26:04.002669
2bcf84db-5cc8-45fa-8a1b-140011317900,account_123,2024-09-28,0.0,203.55,-203.55,17607.87,2025-10-26T02:26:04.002669
653b30b1-3916-4339-965f-96a6bc700eda,account_123,2024-09-29,0.0,256.1,-256.1,17351.77,2025-10-26T02:26:04.002669
01ab9476-aa23-459a-bffa-10f34f9d4f53,account_123,2024-09-30,0.0,122.71,-122.71,17229.06,2025-10-26T02:26:04.002669
cc2c566b-b9da-4a2c-a8a7-4e472a4daaf5,account_123,2024-10-01,12459.86,22.04,12437.82,29666.88,2025-10-26T02:26:04.002669
f2fbbe51-7737-42b6-b544-819f2808bd3c,account_123,2024-10-02,0.0,85.3,-85.3,29581.58,2025-10-26T02:26:04.002669
dabad4db-bb96-4d99-b4cd-d8ee03bf334a,account_123,2024-10-03,0.0,22.19,-22.19,29559.39,2025-10-26T02:26:04.002669
01263a9d-0018-4325-811c-7fc31a52aee8,account_123,2024-10-04,0.0,345.23,-345.23,29214.16,2025-10-26T02:26:04.002669
35a39a84-f461-42a7-87a8-414f45c61860,account_123,2024-10-05,0.0,273.04,-273.04,28941.12,2025-10-26T02:26:04.002669
f89a2519-f50e-4b3a-82e8-e3911247fbb8,account_123,2024-10-06,0.0,273.53,-273.53,28667.59,2025-10-26T02:26:04.002669
c6d68b59-f619-44f6-a2d2-5264411bcbe2,account_123,2024-10-07,0.0,164.43,-164.43,28503.16,2025-10-26T02:26:04.002669
2ea62a29-f02e-4681-aea1-722606c7497c,account_123,2024-10-08,0.0,335.79,-335.79,28167.37,2025-10-26T02:26:04.002669
74f11107-11e0-4500-b7ca-9929cfe0175b,account_123,2024-10-09,0.0,121.09,-121.09,28046.28,2025-10-26T02:26:04.002669
6ad7734f-5b18-4fa7-aad1-8e2a06249ab0,account_123,2024-10-10,0.0,9.83,-9.83,28036.45,2025-10-26T02:26:04.002669
ed769e1f-2678-4fe6-8a89-921ec73339f2,account_123,2024-10-11,0.0,186.77,-186.77,27849.68,2025-10-26T02:26:04.002669
e09af088-6619-4192-9014-017af7bfdc82,account_123,2024-10-12,0.0,849.73,-849.73,26999.95,2025-10-26T02:26:04.002669
265a4185-f934-4164-8850-605c3394d2a3,account_123,2024-10-13,0.0,740.94,-740.94,26259.01,2025-10-26T02:26:04.002669
0aeda1ad-c1c7-46b3-8779-e6058474862b,account_123,2024-10-14,0.0,197.37,-197.37,26061.64,2025-10-26T02:26:04.002669
8d9a0357-9729-4036-8e52-15bfbc275149,account_123,2024-10-15,0.0,4.6,-4.6,26057.04,2025-10-26T02:26:04.002669
3f23176b-c04d-46a1-bf3c-ec3b4f6e8b4b,account_123,2024-10-16,0.0,200.72,-200.72,25856.32,2025-10-26T02:26:04.002669
ec1714b6-2536-40e5-a83f-8e6607810347,account_123,2024-10-17,0.0,499.09,-499.09,25357.23,2025-10-26T02:26:04.002669
1a637947-514e-4022-9fcb-85da36ee09e9,account_123,2024-10-18,0.0,830.8,-830.8,24526.43,2025-10-26T02:26:04.002669
f700447a-c563-4c4a-8379-1e1eee86b3bb,account_123,2024-10-19,0.0,264.02,-264.02,24262.41,2025-10-26T02:26:04.002669
12ada6a9-8cc1-4bea-8bf3-d6aae7776b2b,account_123,2024-10-20,0.0,319.3,-319.3,23943.11,2025-10-26T02:26:04.002669
ad85a332-0ab2-48de-98ac-425a4ea60d2f,account_123,2024-10-21,0.0,1074.12,-1074.12,22868.99,2025-10-26T02:26:04.002669
e38d24fe-1764-4c5f-95eb-7b7138f7955c,account_123,2024-10-22,0.0,749.36,-749.36,22119.63,2025-10-26T02:26:04.002669
194310d4-73a2-480d-88b9-9b80cc6a2c93,account_123,2024-10-23,0.0,466.19,-466.19,21653.44,2025-10-26T02:26:04.002669
ab21589c-fb91-4d88-abb8-72c9080aee68,account_123,2024-10-24,0.0,526.82,-526.82,21126.62,2025-10-26T02:26:04.002669
306f2817-f3c2-4ac6-a495-bd903092796a,account_123,2024-10-25,0.0,294.95,-294.95,20831.67,2025-10-26T02:26:04.002669
652ef9b5-d4e8-4529-be3a-969c9ec646b4,account_123,2024-10-26,0.0,156.58,-156.58,20675.09,2025-10-26T02:26:04.002669
948c5b1c-5df9-47b5-95c9-6c678d77fa49,account_123,2024-10-27,0.0,27.43,-27.43,20647.66,2025-10-26T02:26:04.002669
158de289-79a4-47a3-806b-823d4ecda6fb,account_123,2024-10-28,0.0,364.72,-364.72,20282.94,2025-10-26T02:26:04.002669
0dc2a721-49b3-45bb-9a75-707fe7eff663,account_123,2024-10-30,0.0,107.15,-107.15,20175.79,2025-10-26T02:26:04.002669
c24edd00-679a-4834-b40e-ac43769dc210,account_123,2024-10-31,0.0,130.16,-130.16,20045.63,2025-10-26T02:26:04.002669
56bc3b37-ef82-4805-b91d-7055df0e6328,account_123,2024-11-01,13176.58,115.75,13060.83,33106.46,2025-10-26T02:26:04.002669
5bcb0a41-d090-46db-9e81-35f7a2f208ab,account_123,2024-11-02,0.0,26.86,-26.86,33079.6,2025-10-26T02:26:04.002669
cf08ab75-e015-4a32-ad81-7fde593103c3,account_123,2024-11-03,0.0,367.19,-367.19,32712.41,2025-10-26T02:26:04.002669
a53c330e-e684-4db8-b621-d490fd7aebdc,account_123,2024-11-04,0.0,400.34,-400.34,32312.07,2025-10-26T02:26:04.002669
c00f0782-aa22-4818-bd49-07a3e6314477,account_123,2024-11-05,0.0,123.92,-123.92,32188.15,2025-10-26T02:26:04.002669
2e2f39d0-ea94-4ca5-bf1b-9c71cf8dd4cb,account_123,2024-11-06,0.0,137.19,-137.19,32050.96,2025-10-26T02:26:04.002669
f9698c79-459d-45fa-8b97-ac7502b70b1a,account_123,2024-11-07,0.0,4.63,-4.63,32046.33,2025-10-26T02:26:04.002669
17b82252-6bdc-4c85-bcf4-f1457fefefe0,account_123,2024-11-08,0.0,113.04,-113.04,31933.29,2025-10-26T02:26:04.002669
086e4e0a-ecb5-4585-b503-bb8ffc9ce9cb,account_123,2024-11-09,0.0,390.98,-390.98,31542.31,2025-10-26T02:26:04.002669
adabaa48-0faa-441d-b82e-7b553059d7c4,account_123,2024-11-10,0.0,351.03,-351.03,31191.28,2025-10-26T02:26:04.002669
9be926b7-5999-4eea-9be5-42bd3b013f53,account_123,2024-11-11,0.0,524.17,-524.17,30667.11,2025-10-26T02:26:04.002669
cbbee47c-0fd2-4d63-903a-0e20afdc6300,account_123,2024-11-12,0.0,83.94,-83.94,30583.17,2025-10-26T02:26:04.002669
f5223fd3-02ec-44cb-8c89-5d405c83a74f,account_123,2024-11-13,0.0,306.38,-306.38,30276.79,2025-10-26T02:26:04.002669
76fd1c22-9b9e-404b-b048-5cd3cfd777c1,account_123,2024-11-14,0.0,127.17,-127.17,30149.62,2025-10-26T02:26:04.002669
4daf678b-1924-4a27-8d0a-4b5f2e829b4e,account_123,2024-11-15,0.0,572.71,-572.71,29576.91,2025-10-26T02:26:04.002669
fe80b9ba-1906-455b-b3a6-9f712edec4fa,account_123,2024-11-16,0.0,214.99,-214.99,29361.92,2025-10-26T02:26:04.002669
32d460c9-78d1-4c6e-b0f2-1047235d05e1,account_123,2024-11-17,0.0,123.6,-123.6,29238.32,2025-10-26T02:26:04.002669
16398549-bdee-4d0e-9ea5-e2ed009d80b0,account_123,2024-11-18,0.0,386.56,-386.56,28851.76,2025-10-26T02:26:04.002669
2d4ba94f-73b8-4b3a-9ec9-a68885e9e7f5,account_123,2024-11-19,0.0,9.64,-9.64,28842.12,2025-10-26T02:26:04.002669
caed10b0-1862-4b1e-b72a-9b554fa8b16b,account_123,2024-11-20,0.0,98.01,-98.01,28744.11,2025-10-26T02:26:04.002669
78500e4c-ce4b-4891-8036-bb5c21710442,account_123,2024-11-21,0.0,142.96,-142.96,28601.15,2025-10-26T02:26:04.002669
ba6f8ec4-4045-4da8-a1f4-df4aa9309049,account_123,2024-11-22,0.0,272.53,-272.53,28328.62,2025-10-26T02:26:04.002669
271539ef-e89e-4d20-90e9-0351abdbcddd,account_123,2024-11-23,0.0,149.26,-149.26,28179.36,2025-10-26T02:26:04.002669
5d481d5e-b381-4f92-bc0f-20b4f2ef265e,account_123,2024-11-24,0.0,634.18,-634.18,27545.18,2025-10-26T02:26:04.002669
32a32669-948e-46a4-8475-1fd2a73e2587,account_123,2024-11-25,0.0,96.99,-96.99,27448.19,2025-10-26T02:26:04.002669
efd3dd4f-e93a-4dd2-bdab-ba19f831ea74,account_123,2024-11-26,0.0,305.84,-305.84,27142.35,2025-10-26T02:26:04.002669
abcd42b7-85ba-4415-b0db-b1e711201e33,account_123,2024-11-27,0.0,37.28,-37.28,27105.07,2025-10-26T02:26:04.002669
06516c8e-86ad-4acd-bf74-a661910f0f50,account_123,2024-11-28,0.0,145.16,-145.16,26959.91,2025-10-26T02:26:04.002669
2d158aa7-e66e-41ee-896a-9d1f47ab7c43,account_123,2024-11-29,0.0,410.81,-410.81,26549.1,2025-10-26T02:26:04.002669
92e95e0f-0bbc-4d2d-bc42-3fc4eb5df14f,account_123,2024-11-30,0.0,392.94,-392.94,26156.16,2025-10-26T02:26:04.002669
85ece90e-4cdd-4f4e-a351-d2c51592516b,account_123,2024-12-01,12168.7,1753.6,10415.1,36571.26,2025-10-26T02:26:04.002669
2fbe4195-a36c-4189-b192-778533a52c17,account_123,2024-12-02,0.0,254.5,-254.5,36316.76,2025-10-26T02:26:04.002669
6c025596-1884-4d93-96e9-b7b3859ba9a6,account_123,2024-12-03,0.0,274.55,-274.55,36042.21,2025-10-26T02:26:04.002669
bd2a99d7-d208-4cb0-a829-b26415ffd812,account_123,2024-12-04,0.0,586.85,-586.85,35455.36,2025-10-26T02:26:04.002669
3e540f34-cbb8-47a4-9238-2659f5d6db24,account_123,2024-12-05,0.0,515.34,-515.34,34940.02,2025-10-26T02:26:04.002669
b86ebc2e-0ffb-43d8-a349-6b60fb89e931,account_123,2024-12-06,0.0,1012.31,-1012.31,33927.71,2025-10-26T02:26:04.002669
9ffd0ee0-d995-4b21-abe9-159f12293448,account_123,2024-12-07,0.0,2176.12,-2176.12,31751.59,2025-10-26T02:26:04.002669
5e63de57-84ea-4412-bfcc-b1aace62ea93,account_123,2024-12-08,0.0,922.58,-922.58,30829.01,2025-10-26T02:26:04.002669
af1bc338-0a17-4359-8c27-34dc04696526,account_123,2024-12-09,0.0,420.84,-420.84,30408.17,2025-10-26T02:26:04.002669
fc55c532-c934-4c79-b1d2-d12bd8986a6e,account_123,2024-12-10,0.0,818.49,-818.49,29589.68,2025-10-26T02:26:04.002669
c0758011-3292-4365-bb5a-accc4d4062c5,account_123,2024-12-11,0.0,385.19,-385.19,29204.49,2025-10-26T02:26:04.002669
abe88c70-14cb-4454-86f4-9d8561227b7f,account_123,2024-12-12,0.0,498.93,-498.93,28705.56,2025-10-26T02:26:04.002669
c1b28ff6-4d8d-42aa-96f3-096ccf7e01aa,account_123,2024-12-13,0.0,859.09,-859.09,27846.47,2025-10-26T02:26:04.002669
1f34a5b9-6aa6-403b-9629-0ce14ed3390c,account_123,2024-12-14,0.0,575.43,-575.43,27271.04,2025-10-26T02:26:04.002669
16e0d42e-a634-4773-a246-d4549dd8c89e,account_123,2024-12-15,0.0,701.53,-701.53,26569.51,2025-10-26T02:26:04.002669
6a92a571-48f9-4157-b0bd-769ccca0bf5a,account_123,2024-12-16,0.0,956.59,-956.59,25612.92,2025-10-26T02:26:04.002669
ab0cf760-e25f-454e-bd26-c29bb361aca1,account_123,2024-12-17,0.0,156.9,-156.9,25456.02,2025-10-26T02:26:04.002669
07dfa40a-2b67-487a-b3ab-fbee041007f2,account_123,2024-12-18,0.0,440.44,-440.44,25015.58,2025-10-26T02:26:04.002669
0c75a609-e393-42d7-8c81-97ae193a2c34,account_123,2024-12-19,0.0,361.17,-361.17,24654.41,2025-10-26T02:26:04.002669
c8c83ecc-438a-426a-9d63-b480d52d931c,account_123,2024-12-20,0.0,362.17,-362.17,24292.24,2025-10-26T02:26:04.002669
a5ceb6e7-6cb2-4620-8679-8be59afa2bac,account_123,2024-12-21,0.0,2449.22,-2449.22,21843.02,2025-10-26T02:26:04.002669
959e2f84-4e86-47d6-9e22-eb5443a1da9e,account_123,2024-12-22,0.0,578.14,-578.14,21264.88,2025-10-26T02:26:04.002669
73e2fe74-6214-478a-af3c-94f754298c40,account_123,2024-12-23,0.0,601.47,-601.47,20663.41,2025-10-26T02:26:04.002669
f7838c9b-269e-4763-afc1-4a69fcdf5933,account_123,2024-12-24,0.0,790.97,-790.97,19872.44,2025-10-26T02:26:04.002669
72c89f57-210b-475a-9301-4f847da73667,account_123,2024-12-25,0.0,273.48,-273.48,19598.96,2025-10-26T02:26:04.002669
e64222c3-747c-4367-8da5-163fd82d6264,account_123,2024-12-26,0.0,1273.85,-1273.85,18325.11,2025-10-26T02:26:04.002669
20ac4f9b-a7eb-444d-98fd-e553aa6129d7,account_123,2024-12-27,0.0,682.32,-682.32,17642.79,2025-10-26T02:26:04.002669
bb5ac365-41ae-49f3-9ec6-e87c9f4615b2,account_123,2024-12-28,0.0,1030.64,-1030.64,16612.15,2025-10-26T02:26:04.002669
d235b90a-78eb-46c2-9bd3-da0af3678f8c,account_123,2024-12-29,0.0,661.97,-661.97,15950.18,2025-10-26T02:26:04.002669
9c822ac4-7505-4f8f-a6d1-9135c90bb301,account_123,2024-12-30,0.0,517.33,-517.33,15432.85,2025-10-26T02:26:04.002669
e6d5534a-af7e-4333-93f5-d9f026d12579,account_123,2024-12-31,0.0,3746.17,-3746.17,11686.68,2025-10-26T02:26:04.002669
598850fe-dd5b-4f0f-8282-4f76f10294a6,account_123,2025-01-01,12606.8,180.43,12426.37,24113.05,2025-10-26T02:26:04.002669
43942525-1ead-4e35-b4fa-80c223196abe,account_123,2025-01-02,0.0,91.79,-91.79,24021.26,2025-10-26T02:26:04.002669
e40e6a10-c390-4e74-b70b-79bee2fe7a59,account_123,2025-01-03,0.0,134.02,-134.02,23887.24,2025-10-26T02:26:04.002669
73c6fe1e-c936-41a1-bc0c-41b1bfa35379,account_123,2025-01-04,0.0,195.57,-195.57,23691.67,2025-10-26T02:26:04.002669
cd9006ee-2944-400a-844c-6c7960a9ee9d,account_123,2025-01-05,0.0,249.95,-249.95,23441.72,2025-10-26T02:26:04.002669
546cc616-b882-4494-9f26-6d8e8b6cba80,account_123,2025-01-06,0.0,236.87,-236.87,23204.85,2025-10-26T02:26:04.002669
ae02cf13-8237-421b-acab-6e8319e11c32,account_123,2025-01-07,0.0,117.28,-117.28,23087.57,2025-10-26T02:26:04.002669
67f40a0f-ac8a-420a-93a2-49b1e581dc81,account_123,2025-01-09,0.0,70.16,-70.16,23017.41,2025-10-26T02:26:04.002669
0e8f3b0e-5303-4594-9bcd-f8f6e3bf50a3,account_123,2025-01-10,0.0,1.06,-1.06,23016.35,2025-10-26T02:26:04.002669
953146c8-ad17-4646-87f4-8ca4f3c30eca,account_123,2025-01-12,0.0,574.94,-574.94,22116.41,2025-10-26T02:26:04.002669
2bc4d411-c288-4a99-85ac-ae7630725702,account_123,2025-01-13,0.0,301.5,-301.5,21814.91,2025-10-26T02:26:04.002669
dcc5dadc-6f96-4122-a28a-6c7537fab3ac,account_123,2025-01-16,0.0,936.1,-936.1,20878.81,2025-10-26T02:26:04.002669
156a6aee-e57d-4faa-93e9-32f4faefdc6b,account_123,2025-01-18,0.0,238.15,-238.15,20640.66,2025-10-26T02:26:04.002669
d49264cb-a608-45fa-b0f9-d59d3a5c2a93,account_123,2025-01-19,0.0,85.29,-85.29,20555.37,2025-10-26T02:26:04.002669
5817501d-1af7-494c-90ff-d1a36c2e4984,account_123,2025-01-20,0.0,782.98,-782.98,19772.39,2025-10-26T02:26:04.002669
5d794c95-016e-407f-97ad-41d6dcabb7bd,account_123,2025-01-21,0.0,195.82,-195.82,19576.57,2025-10-26T02:26:04.002669
a5322192-5895-47fd-b434-ecdcfefb34d1,account_123,2025-01-22,0.0,135.67,-135.67,19440.9,2025-10-26T02:26:04.002669
359628b9-f8ed-483e-9197-654b205b238d,account_123,2025-01-23,0.0,313.7,-313.7,19127.2,2025-10-26T02:26:04.002669
7c6d3c71-a851-4313-9f9c-a7c43e55e3cf,account_123,2025-01-24,0.0,45.51,-45.51,19081.69,2025-10-26T02:26:04.002669
55a78c73-c311-4d48-a8dc-a7e3e9bc0592,account_123,2025-01-25,0.0,992.46,-992.46,18089.23,2025-10-26T02:26:04.002669
14cacd01-fb0c-40fb-b057-a06b363a7f21,account_123,2025-01-26,0.0,96.39,-96.39,17992.84,2025-10-26T02:26:04.002669
b30fe03c-894b-468d-95c2-d3c9f599beaa,account_123,2025-01-27,0.0,52.44,-52.44,17940.4,2025-10-26T02:26:04.002669
4e7fc12f-50a2-4b28-a0cd-7e8f213fff74,account_123,2025-01-28,0.0,116.88,-116.88,17823.52,2025-10-26T02:26:04.002669
fca60dbc-27fd-4acd-98f7-20922790a3fa,account_123,2025-01-29,0.0,20.88,-20.88,17802.64,2025-10-26T02:26:04.002669
5e6e5e04-6dab-4078-93f8-ba79aee7f478,account_123,2025-01-30,0.0,188.57,-188.57,17614.07,2025-10-26T02:26:04.002669
87a0aacf-0c94-4084-b942-347b450f8730,account_123,2025-01-31,0.0,202.37,-202.37,17411.7,2025-10-26T02:26:04.002669
60d42f79-332e-4642-b97f-81edda8f364e,account_123,2025-02-01,13350.28,223.98,13126.3,30538.0,2025-10-26T02:26:04.002669
267c5180-5167-4167-ba46-b0257df479b3,account_123,2025-02-02,0.0,211.2,-211.2,30326.8,2025-10-26T02:26:04.002669
cd1a67e6-8bef-4672-8db8-dfa5e4871d3c,account_123,2025-02-03,0.0,266.01,-266.01,30060.79,2025-10-26T02:26:04.002669
744167ee-fc5e-4363-8368-abffdaeb46e0,account_123,2025-02-05,0.0,190.55,-190.55,29870.24,2025-10-26T02:26:04.002669
ba84cfa5-b833-4cfc-8b89-b45608df0d0f,account_123,2025-02-06,0.0,192.68,-192.68,29677.56,2025-10-26T02:26:04.002669
d244264f-0bb9-4e6b-978c-ef6abb2cb914,account_123,2025-02-07,0.0,414.3,-414.3,29263.26,2025-10-26T02:26:04.002669
4eefcf0d-5d12-45a2-85b0-735b666fbc50,account_123,2025-02-08,0.0,408.79,-408.79,28854.47,2025-10-26T02:26:04.002669
f7164867-ee62-4804-8168-38f67a98eef0,account_123,2025-02-09,0.0,260.61,-260.61,28593.86,2025-10-26T02:26:04.002669
30027ed0-8883-4342-8ec8-074b918fa9f5,account_123,2025-02-10,0.0,94.37,-94.37,28499.49,2025-10-26T02:26:04.002669
9a820ba5-eb93-4757-966c-2d85ebef512b,account_123,2025-02-12,0.0,807.6,-807.6,27691.89,2025-10-26T02:26:04.002669
83cdb2f3-f17e-4c20-b373-38b60eb399b8,account_123,2025-02-13,0.0,7.11,-7.11,27684.78,2025-10-26T02:26:04.002669
de1bd723-2298-4b6c-ae05-c623047cdb0b,account_123,2025-02-14,0.0,246.07,-246.07,27438.71,2025-10-26T02:26:04.002669
5751b5b3-63b2-499e-a908-672f4f13c5bf,account_123,2025-02-15,0.0,138.89,-138.89,27299.82,2025-10-26T02:26:04.002669
b29704bf-4070-4053-b381-3a823b7dae54,account_123,2025-02-16,0.0,170.44,-170.44,27129.38,2025-10-26T02:26:04.002669
3a5d6dc9-354e-4445-aef6-fca6eca13c46,account_123,2025-02-17,0.0,273.5,-273.5,26855.88,2025-10-26T02:26:04.002669
05fea5ac-a7b4-4d20-9eee-adc0211775dd,account_123,2025-02-18,0.0,142.61,-142.61,26713.27,2025-10-26T02:26:04.002669
00af952b-5864-4859-9977-6b7872ba0cc0,account_123,2025-02-19,0.0,110.49,-110.49,26602.78,2025-10-26T02:26:04.002669
218462ea-a060-42e0-95fd-b70b5ad6c15c,account_123,2025-02-20,0.0,213.53,-213.53,26389.25,2025-10-26T02:26:04.002669
6eaaa7a0-ca06-4e49-914a-7119081da9a5,account_123,2025-02-21,0.0,362.85,-362.85,26026.4,2025-10-26T02:26:04.002669
a86066e0-024c-4759-bdf5-0c5d3d11f3e2,account_123,2025-02-22,0.0,133.81,-133.81,25892.59,2025-10-26T02:26:04.002669
66e76c22-5411-404b-b560-29381c083ba5,account_123,2025-02-23,0.0,1072.95,-1072.95,24819.64,2025-10-26T02:26:04.002669
76051bfe-4faf-4a65-919a-5284452574ba,account_123,2025-02-24,0.0,67.2,-67.2,24752.44,2025-10-26T02:26:04.002669
d6e06b2f-a38c-4a09-a80b-6a12bd8a3ad1,account_123,2025-02-25,0.0,103.18,-103.18,24649.26,2025-10-26T02:26:04.002669
bf70b44c-bb3e-4195-b119-bcbfd31ece98,account_123,2025-02-26,0.0,81.57,-81.57,24567.69,2025-10-26T02:26:04.002669
5ef7212e-71be-4103-9fcc-b9a446df9f6b,account_123,2025-02-27,0.0,237.77,-237.77,24329.92,2025-10-26T02:26:04.002669
4797fa1a-3dd7-4e1d-a373-03401c73020b,account_123,2025-02-28,0.0,135.76,-135.76,24194.16,2025-10-26T02:26:04.002669
53617280-bbf5-4ab7-bc1d-f85aba4dfb6f,account_123,2025-03-01,12739.83,260.41,12479.42,36673.58,2025-10-26T02:26:04.002669
d1748bf7-9256-491f-aa13-585a755ec53c,account_123,2025-03-02,0.0,727.59,-727.59,35945.99,2025-10-26T02:26:04.002669
ee4802a3-a89c-4324-92fe-581342d91ea4,account_123,2025-03-03,0.0,582.05,-582.05,35363.94,2025-10-26T02:26:04.002669
95a44dfa-d926-45de-b223-db02b6c9d417,account_123,2025-03-04,0.0,19.47,-19.47,35344.47,2025-10-26T02:26:04.002669
cba945a7-4dbb-4d93-9db1-e428b392d5ec,account_123,2025-03-05,0.0,1.22,-1.22,35343.25,2025-10-26T02:26:04.002669
0274ba1f-194e-49a6-b02a-230e36c2cdd4,account_123,2025-03-06,0.0,322.65,-322.65,35020.6,2025-10-26T02:26:04.002669
ecf34977-fcd1-4364-b912-42ecdebb1725,account_123,2025-03-07,0.0,163.91,-163.91,34856.69,2025-10-26T02:26:04.002669
861c4a5c-2d5c-41d1-a965-0fa8735a7624,account_123,2025-03-08,0.0,297.32,-297.32,34559.37,2025-10-26T02:26:04.002669
e95fa459-aae0-4d17-a26b-b3f7b8afacae,account_123,2025-03-09,0.0,531.27,-531.27,34028.1,2025-10-26T02:26:04.002669
22092d7e-da46-4a06-b074-c6d728c0c7cf,account_123,2025-03-10,0.0,98.45,-98.45,33929.65,2025-10-26T02:26:04.002669
517001ec-17ed-4ecd-b554-bab9a6bdf635,account_123,2025-03-11,0.0,166.87,-166.87,33762.78,2025-10-26T02:26:04.002669
a4a2c475-7c9e-4892-aef1-615421f1354e,account_123,2025-03-12,0.0,164.28,-164.28,33598.5,2025-10-26T02:26:04.002669
1f112681-1163-4b71-bb0e-a17ba06f8906,account_123,2025-03-13,0.0,157.53,-157.53,33440.97,2025-10-26T02:26:04.002669
b9271c90-58b2-4880-af0d-a69ab535e292,account_123,2025-03-14,0.0,510.67,-510.67,32930.3,2025-10-26T02:26:04.002669
29970fa7-780f-4a6a-8cca-18644a286804,account_123,2025-03-15,0.0,238.61,-238.61,32691.69,2025-10-26T02:26:04.002669
49e3807a-8dbf-4baf-b7e5-7c3d3f779ab3,account_123,2025-03-16,0.0,375.85,-375.85,32315.84,2025-10-26T02:26:04.002669
266d150d-ed9d-470d-a2ae-af9320c04f1f,account_123,2025-03-17,0.0,91.84,-91.84,32224.0,2025-10-26T02:26:04.002669
e7f711fd-f433-410c-a66f-8deb28e3fefe,account_123,2025-03-18,0.0,288.91,-288.91,31935.09,2025-10-26T02:26:04.002669
538fda05-ebe9-44de-a2d3-625209645fc4,account_123,2025-03-19,0.0,292.79,-292.79,31642.3,2025-10-26T02:26:04.002669
14530e6a-90f7-4623-b858-79e6c3ddc9ac,account_123,2025-03-20,0.0,45.79,-45.79,31596.51,2025-10-26T02:26:04.002669
ab046d84-041e-4341-afe4-8d29353c2784,account_123,2025-03-21,0.0,149.77,-149.77,31446.74,2025-10-26T02:26:04.002669
8ebb0f87-959f-4cce-b707-147da92b50a2,account_123,2025-03-22,0.0,550.61,-550.61,30896.13,2025-10-26T02:26:04.002669
976c591b-fa89-4cc9-8b24-0255151f3e4a,account_123,2025-03-23,0.0,379.62,-379.62,30516.51,2025-10-26T02:26:04.002669
ed6a211d-5a70-4800-b6a2-ba918e7da1bf,account_123,2025-03-24,0.0,196.15,-196.15,30320.36,2025-10-26T02:26:04.002669
0ed41eb9-71c2-4c77-a8be-5502f72b0a09,account_123,2025-03-25,0.0,74.55,-74.55,30245.81,2025-10-26T02:26:04.002669
f0b89d9c-3ccb-49b4-8518-43cbc692d87f,account_123,2025-03-26,0.0,483.2,-483.2,29762.61,2025-10-26T02:26:04.002669
1ec36df0-2b63-4f00-b158-9f0585961080,account_123,2025-03-27,0.0,843.24,-843.24,28919.37,2025-10-26T02:26:04.002669
feddf0ca-811a-4a31-ba4e-f110192b9a6b,account_123,2025-03-28,0.0,399.46,-399.46,28519.91,2025-10-26T02:26:04.002669
a421b1a4-375b-49f1-bc80-643601dddcc0,account_123,2025-03-29,0.0,406.04,-406.04,28113.87,2025-10-26T02:26:04.002669
f0f9ced7-eb9b-42f6-9b96-0aec269e2fda,account_123,2025-03-30,0.0,383.34,-383.34,27730.53,2025-10-26T02:26:04.002669
8a52427f-bf76-4930-bb25-29a947fbcab4,account_123,2025-03-31,0.0,528.85,-528.85,27201.68,2025-10-26T02:26:04.002669
5da205d5-c7eb-4d15-a30d-ff7606b69dc9,account_123,2025-04-01,12419.56,286.17,12133.39,39335.07,2025-10-26T02:26:04.002669
a54c57a2-c50e-490e-9e49-5764189924a0,account_123,2025-04-02,0.0,203.64,-203.64,39131.43,2025-10-26T02:26:04.002669
ba6dc266-405a-467b-b624-168e170b02c1,account_123,2025-04-03,0.0,421.69,-421.69,38709.74,2025-10-26T02:26:04.002669
d8baa5a5-34f9-426e-87ae-5640fc0839ab,account_123,2025-04-04,0.0,1028.57,-1028.57,37681.17,2025-10-26T02:26:04.002669
d2ddcbec-511c-4c05-85c7-9de34d7ad31c,account_123,2025-04-05,0.0,270.42,-270.42,37410.75,2025-10-26T02:26:04.002669
28323171-e0d5-496c-a741-d5620e691da1,account_123,2025-04-06,0.0,217.61,-217.61,37193.14,2025-10-26T02:26:04.002669
e766abb2-c8a6-4584-a445-1c9a332b5674,account_123,2025-04-07,0.0,251.9,-251.9,36941.24,2025-10-26T02:26:04.002669
65d65ccc-3a98-4a17-907c-62bba1daf204,account_123,2025-04-08,0.0,55.2,-55.2,36886.04,2025-10-26T02:26:04.002669
c3dec5e0-74d9-4308-bf9b-8400f8a9eaeb,account_123,2025-04-09,0.0,656.23,-656.23,36229.81,2025-10-26T02:26:04.002669
abf72d7c-f58d-4957-a2d5-8e0e3a07ce1f,account_123,2025-04-10,0.0,168.33,-168.33,36061.48,2025-10-26T02:26:04.002669
be104a32-a23c-4105-b1fa-0ffc3bede02f,account_123,2025-04-11,0.0,46.21,-46.21,36015.27,2025-10-26T02:26:04.002669
5a5c8ec7-57c3-4fde-b8a5-7dff6216a9c4,account_123,2025-04-12,0.0,420.02,-420.02,35595.25,2025-10-26T02:26:04.002669
58203b85-bf55-405d-9fa6-44f64699e972,account_123,2025-04-13,0.0,409.39,-409.39,35185.86,2025-10-26T02:26:04.002669
ddd77dd1-7260-4b04-993c-ff044258dcd5,account_123,2025-04-14,0.0,196.26,-196.26,34989.6,2025-10-26T02:26:04.002669
ae6864a0-7a89-41fe-807c-f1c569afb10a,account_123,2025-04-15,0.0,136.12,-136.12,34853.48,2025-10-26T02:26:04.002669
8ce4bb9f-95b5-4cec-bc5f-c1e644df9b1f,account_123,2025-04-16,0.0,466.2,-466.2,34387.28,2025-10-26T02:26:04.002669
fdeeb998-b74c-46dc-a332-584f062c7a00,account_123,2025-04-17,0.0,310.54,-310.54,34076.74,2025-10-26T02:26:04.002669
9fb4d448-cd2f-43d3-82d4-ece749b20b20,account_123,2025-04-18,0.0,201.18,-201.18,33875.56,2025-10-26T02:26:04.002669
10db2910-141d-41f1-9269-486e3b2658bc,account_123,2025-04-19,0.0,303.25,-303.25,33572.31,2025-10-26T02:26:04.002669
e3a3390e-db64-43c9-958e-2ac460f05f81,account_123,2025-04-20,0.0,495.42,-495.42,33076.89,2025-10-26T02:26:04.002669
67db79e2-b194-481d-a239-9ac99425c91f,account_123,2025-04-21,0.0,207.18,-207.18,32869.71,2025-10-26T02:26:04.002669
e64bebc1-a345-42d4-bde4-8401a2114396,account_123,2025-04-22,0.0,136.67,-136.67,32733.04,2025-10-26T02:26:04.002669
70bafba6-41e0-468f-955a-eeeb2a636411,account_123,2025-04-23,0.0,97.16,-97.16,32635.88,2025-10-26T02:26:04.002669
0ef020d1-f39f-4c58-876e-01263739192c,account_123,2025-04-24,0.0,52.65,-52.65,32583.23,2025-10-26T02:26:04.002669
9cbc56fa-264c-492d-a13c-19b504881669,account_123,2025-04-25,0.0,270.34,-270.34,32312.89,2025-10-26T02:26:04.002669
4bb9c873-506d-4276-af18-adcecac1222d,account_123,2025-04-26,0.0,240.29,-240.29,32072.6,2025-10-26T02:26:04.002669
be5bc627-6661-4908-a78a-d907a81d6edb,account_123,2025-04-27,0.0,214.88,-214.88,31857.72,2025-10-26T02:26:04.002669
cfccb21f-30d1-47d0-ba00-a590393012e7,account_123,2025-04-29,0.0,144.1,-144.1,31232.62,2025-10-26T02:26:04.002669
9763f1c8-d487-422a-96fc-36f30752293c,account_123,2025-04-30,0.0,163.2,-163.2,31069.42,2025-10-26T02:26:04.002669
010218d8-7dcf-4029-b26a-beceef4184fc,account_123,2025-05-01,12378.68,151.93,12226.75,43296.17,2025-10-26T02:26:04.002669
292a592b-2957-4c4c-ab99-a7574905b440,account_123,2025-05-02,0.0,326.34,-326.34,42969.83,2025-10-26T02:26:04.002669
0f94a461-a2f1-49cb-b057-2bca2656bac3,account_123,2025-05-03,0.0,233.08,-233.08,42736.75,2025-10-26T02:26:04.002669
74e672d7-55fd-45eb-8740-c51a1fcfc71f,account_123,2025-05-04,0.0,635.41,-635.41,42101.34,2025-10-26T02:26:04.002669
b98caca3-1bba-44aa-8335-89d838b42a78,account_123,2025-05-05,0.0,384.64,-384.64,41716.7,2025-10-26T02:26:04.002669
eef37ffe-3b1e-4294-a11b-8c081c2599ae,account_123,2025-05-06,0.0,133.81,-133.81,41582.89,2025-10-26T02:26:04.002669
250d2f83-202b-42d1-8884-8275056be0f1,account_123,2025-05-07,0.0,534.63,-534.63,41048.26,2025-10-26T02:26:04.002669
aa2a5809-02c2-4960-b43b-d6cacb36f52b,account_123,2025-05-08,0.0,136.95,-136.95,40911.31,2025-10-26T02:26:04.002669
5e3d55b0-9484-4859-8b04-0f318d571c6c,account_123,2025-05-09,0.0,103.7,-103.7,40807.61,2025-10-26T02:26:04.002669
647e4451-8985-436f-900d-285cfc8e0e00,account_123,2025-05-10,0.0,54.15,-54.15,40753.46,2025-10-26T02:26:04.002669
5881a975-95a0-46a7-879b-97e7aad3f50f,account_123,2025-05-11,0.0,507.45,-507.45,40246.01,2025-10-26T02:26:04.002669
fe678e01-e81b-4989-84df-b8333ffca4f8,account_123,2025-05-12,0.0,136.8,-136.8,40109.21,2025-10-26T02:26:04.002669
95f2fcf5-670d-4ce0-88d1-f0eea7d5c9bc,account_123,2025-05-13,0.0,853.21,-853.21,39256.0,2025-10-26T02:26:04.002669
9fe4b8b5-c721-4a5d-bf55-ce62f7c1fe35,account_123,2025-05-14,0.0,592.09,-592.09,38663.91,2025-10-26T02:26:04.002669
e97d207a-3d40-4e61-a506-2e6dd6e118d4,account_123,2025-05-15,0.0,12.24,-12.24,38651.67,2025-10-26T02:26:04.002669
851e0ba0-c222-44f6-bbc3-91507d88f61b,account_123,2025-05-16,0.0,89.32,-89.32,38562.35,2025-10-26T02:26:04.002669
a44e2bce-dcb0-4f98-af13-6657749975e6,account_123,2025-05-17,0.0,133.65,-133.65,38428.7,2025-10-26T02:26:04.002669
f5016d44-106c-4bd7-a9ca-2cd2a18529b9,account_123,2025-05-18,0.0,171.92,-171.92,38256.78,2025-10-26T02:26:04.002669
cd7c38a8-a803-4c60-bbda-7fb00f9a8a20,account_123,2025-05-19,0.0,85.62,-85.62,38171.16,2025-10-26T02:26:04.002669
93f62940-0228-45c9-a9d5-df2f7cdbb538,account_123,2025-05-20,0.0,147.29,-147.29,38023.87,2025-10-26T02:26:04.002669
008433ed-4b71-46c8-83a6-b5bfd74c6b27,account_123,2025-05-21,0.0,228.22,-228.22,37795.65,2025-10-26T02:26:04.002669
eb856076-3623-4161-872f-493babb4689e,account_123,2025-05-23,0.0,22.08,-22.08,37773.57,2025-10-26T02:26:04.002669
1889f7d6-78aa-42b2-a5d0-462b9498f100,account_123,2025-05-24,0.0,383.48,-383.48,37390.09,2025-10-26T02:26:04.002669
37b515bd-ed45-407f-bcc2-347c3eee6452,account_123,2025-05-25,0.0,198.12,-198.12,37191.97,2025-10-26T02:26:04.002669
4d5e8db1-ef7c-493a-b27a-68c31b3da280,account_123,2025-05-26,0.0,309.02,-309.02,36882.95,2025-10-26T02:26:04.002669
8ddc1016-42d9-4fb6-b9fb-aac65594ff53,account_123,2025-05-27,0.0,76.59,-76.59,36806.36,2025-10-26T02:26:04.002669
31281ca9-e3b8-492d-82f2-8fac6e6e9b0c,account_123,2025-05-28,0.0,434.53,-434.53,36371.83,2025-10-26T02:26:04.002669
4be79835-a14d-4df4-a6a1-efebc82e7350,account_123,2025-05-29,0.0,218.35,-218.35,36153.48,2025-10-26T02:26:04.002669
07852d99-35b5-4d33-a518-a577460fe7af,account_123,2025-05-30,0.0,422.36,-422.36,35731.12,2025-10-26T02:26:04.002669
f915e2ab-6aa9-4bca-9e47-6a25882208e7,account_123,2025-05-31,0.0,842.87,-842.87,34888.25,2025-10-26T02:26:04.002669
a32ca858-5fa7-4452-8493-924adc7a3748,account_123,2025-06-01,13116.09,402.24,12713.85,47602.1,2025-10-26T02:26:04.002669
b256da90-3bb2-4730-aea1-5c4461f49129,account_123,2025-06-02,0.0,483.34,-483.34,47118.76,2025-10-26T02:26:04.002669
7a1acf70-f263-470f-b3ab-276c3d8fc705,account_123,2025-06-03,0.0,701.18,-701.18,46417.58,2025-10-26T02:26:04.002669
29633539-3a7a-466f-8fe6-ad8fca7dce3b,account_123,2025-06-04,0.0,220.49,-220.49,46197.09,2025-10-26T02:26:04.002669
72609b32-7291-4295-846b-9da250f33412,account_123,2025-06-05,0.0,180.37,-180.37,46016.72,2025-10-26T02:26:04.002669
eea1fbf0-81fa-4e17-8c31-d4dfa205d487,account_123,2025-06-06,0.0,216.07,-216.07,45800.65,2025-10-26T02:26:04.002669
7a574f3d-6713-4468-8fb8-042a97a294dc,account_123,2025-06-07,0.0,471.9,-471.9,45328.75,2025-10-26T02:26:04.002669
1f1a786b-87c0-4248-a943-5738300e5467,account_123,2025-06-08,0.0,1391.45,-1391.45,43937.3,2025-10-26T02:26:04.002669
5d7b0d90-b98d-42b2-8f85-c81c31b6e7e6,account_123,2025-06-09,0.0,571.03,-571.03,43366.27,2025-10-26T02:26:04.002669
3fda7809-f358-4812-ba3b-372fb111eeb7,account_123,2025-06-10,0.0,36.29,-36.29,43329.98,2025-10-26T02:26:04.002669
f09396b3-d158-4970-aaf8-a95e86c894be,account_123,2025-06-11,0.0,133.57,-133.57,43196.41,2025-10-26T02:26:04.002669
f1a53856-e8c1-4b6a-ad86-61d75dd2c98c,account_123,2025-06-12,0.0,611.34,-611.34,42585.07,2025-10-26T02:26:04.002669
5eae3f26-cee2-4bde-b908-37ff92c3c969,account_123,2025-06-13,0.0,126.37,-126.37,42458.7,2025-10-26T02:26:04.002669
ddd853cf-ac3c-4a43-a1da-67943be9951c,account_123,2025-06-14,0.0,350.24,-350.24,42108.46,2025-10-26T02:26:04.002669
aa8b2339-b94c-47e6-935a-4fd169dbb1bd,account_123,2025-06-15,0.0,1918.81,-1918.81,40189.65,2025-10-26T02:26:04.002669
7df5f660-5402-4c38-962f-cd0ee4fc2b69,account_123,2025-06-16,0.0,274.16,-274.16,39915.49,2025-10-26T02:26:04.002669
4e5d9082-7d76-4868-a000-e1f7d6ba333b,account_123,2025-06-17,0.0,63.88,-63.88,39851.61,2025-10-26T02:26:04.002669
0d20d86f-53da-4520-982d-98955886d941,account_123,2025-06-18,0.0,215.05,-215.05,39636.56,2025-10-26T02:26:04.002669
b39113ae-0692-4b08-a687-6bfcac954b97,account_123,2025-06-19,0.0,723.47,-723.47,38913.09,2025-10-26T02:26:04.002669
ac494221-9177-4405-8bf2-05f662b799ef,account_123,2025-06-20,0.0,332.59,-332.59,38580.5,2025-10-26T02:26:04.002669
ebc45bcf-990c-45de-bb37-3b82876c9ad9,onlyfans,2024-01-01,0.0,13259.52,-13259.52,-13259.52,2025-10-26T02:26:04.002669
43241fda-dccc-40ab-ab90-821c20e4792e,onlyfans,2024-02-01,0.0,13142.02,-13142.02,-26401.54,2025-10-26T02:26:04.002669
fa221c25-4f29-4eae-ab84-35d4f59eecca,onlyfans,2024-03-01,0.0,13023.96,-13023.96,-39425.5,2025-10-26T02:26:04.002669
9b688666-9e77-4a9e-ac04-58b099002f7b,onlyfans,2024-04-01,0.0,12840.74,-12840.74,-52266.24,2025-10-26T02:26:04.002669
c013e5cd-bc95-4be4-8627-5681cf60ba36,onlyfans,2024-05-01,0.0,13063.98,-13063.98,-65330.22,2025-10-26T02:26:04.002669
b5900202-a6d4-4cde-8179-477d1b3fc28a,onlyfans,2024-06-01,0.0,12201.81,-12201.81,-77532.03,2025-10-26T02:26:04.002669
d1296226-aea6-44db-a2c7-570124d3034f,onlyfans,2024-07-01,0.0,13265.65,-13265.65,-90797.68,2025-10-26T02:26:04.002669
27d84c67-b85a-4b17-97d6-206c6ffffb9a,onlyfans,2024-08-01,0.0,12376.21,-12376.21,-103173.89,2025-10-26T02:26:04.002669
e58c141a-403a-4c76-bd29-758110e89290,onlyfans,2024-09-01,0.0,12908.26,-12908.26,-116082.15,2025-10-26T02:26:04.002669
245cc25c-f985-43ea-8232-64113b1c353b,onlyfans,2024-10-01,0.0,12459.86,-12459.86,-128542.01,2025-10-26T02:26:04.002669
291961d0-7b85-4300-bf79-1680795f9b70,onlyfans,2024-11-01,0.0,13176.58,-13176.58,-141718.59,2025-10-26T02:26:04.002669
516a0695-0a70-4958-ae39-32df07011a3b,onlyfans,2024-12-01,0.0,12168.7,-12168.7,-153887.29,2025-10-26T02:26:04.002669
cba2aa6c-f790-4c40-b840-ad29f5afa423,onlyfans,2025-01-01,0.0,12606.8,-12606.8,-166494.09,2025-10-26T02:26:04.002669
9880b05a-542a-450a-970d-ff5f9826ac34,onlyfans,2025-02-01,0.0,13350.28,-13350.28,-179844.37,2025-10-26T02:26:04.002669
fe30e4ca-34a7-466b-acd9-9eb76f6d0cca,onlyfans,2025-03-01,0.0,12739.83,-12739.83,-192584.2,2025-10-26T02:26:04.002669
64aed536-70fa-4e30-b753-2a9fd783499a,onlyfans,2025-04-01,0.0,12419.56,-12419.56,-205003.76,2025-10-26T02:26:04.002669
1cd7c6a0-08b9-447b-b9ec-5cb4e39c3f61,onlyfans,2025-05-01,0.0,12378.68,-12378.68,-217382.44,2025-10-26T02:26:04.002669
2b252703-901d-4400-84fe-4fd502c6764e,onlyfans,2025-06-01,0.0,13116.09,-13116.09,-230498.53,2025-10-26T02:26:04.002669
